NO textures/north.png

SO     textures/south.png


EA     textures/east.png

WE      textures/west.png


C 135,142,   50

F 107,1,200


 11111111111111111111111111111
1000000000000000000100000E00001
100011111111111000001000011111
1000100000000010000010000100001
1000100000000010000010000100001
1000100001111110000000000111001
1000100000000000000010000001001
1000100001000100000010000001001
1000000010010000000100000000001
1111000001111111111110000000111
1000000001000000000010000000001
1000000001000000000000000000001
1000100001111110000000000111001
1000100000000000000010000001001
1000100001000100000010000001001
1000000001001000000010000000001
1111111111111111111111111111111