NO textures/north.png

SO     textures/south.png

EA     textures/east.png

WE      textures/west.png

C 135, 206,          235
F 107,142,35


11111111111111111111111111111111111111111111111111
10000000001100000000110000000001100000000000111111
10111111101101111110110111111101101111110110000001
101000001011011E0000110110000001101100000111111101
10101110111101101111110111101111101101111110000001
10100010000001100000000000001100001100000111110101
10111110111111101111111110111111101111111110110101
10000010100000000001100000000001100000000010110101
11111010101111110110101111111110111111110110110101
10001000100000100000000000000100000000100010110101
10111111101111101111111111111111111111110110110101
10000000001100001100000100000000000000000010110001
10111111101101111101110111111111111111110110110111
10000000101100000000110100000000000000010110000001
10111110101111111111110111111111111111110110111101
10100010100000000000100000000001100000000010000101
10101111111111110110111111111111101111111110111101
10000000000000110110100000000000001100000110000001
10111111111110110110111111111111111111110111111101
10100000000010100000100000000000000000010100000001
10101111110110111111101111111111111111110111110101
10100000100000000000000000000100000000100010000101
11111110111111111111111111110111111110111110111101
10000010000000100000000100000000000100000000100001
10111111111110111111110111111111111111111110111111
10000000000000000000000100000000000000000000000001
11111111111111111111110111111111111111111111111101
10000000000000000000000000000000000000000000000001
11111111111111111111111111111111111111111111111111
