NO textures/test/north.png



SO         textures/test/south.png


EA     textures/test/east.png
WE      textures/test/west.png

C 135,          206,235



F     34    ,   139,             34

1111111111111111111111111111111
1000000000000000000010000000001
1000111111111110000010000111111
1000100000000010000010000100001
10001000000000100N0010000100001
1000100001111110000010000111001
1000100000000000000010000001001
1000100001000000000010000001001
1000000001000000000010000000001
1111000001111111110110000000111
1000000001000000000010000000001
1000000001000000000000000000001
1000111111111111111110000111111
1000000000000000000000000000001
1000111111111110000000000100111
1000000000000010000000000100001
1110111111000011111111111110001
1000000001000000000000000010001
1000000001000000000000000010001
1111111111111111111111111111111
