NO textures/north.png

SO         textures/south.png

EA     textures/robot.png

WE      textures/west.png

C 135, 206, 235

F 107,142,35

1111
1001
1101
1101111111111111111111111111111
1000000000000000000S10000000001
1000111111111110000010000111111
1000100000000010000010000100001
1000100000000010000010000100001
1000100001111110000000000111001
1000100000000000000010000001001
1000100001000100000010000001001
1000000001001000000010000000001
1111000001111111110110000000111
1000000001000000000010000000001
1000000001000000000000000000001
1000100001111110000000000111001
1000100000000000000010000001001
1000100001000100000010000001001
1000000001001000000010000000001
1111000001111111110110000000111
1000000001000000000010000000001
1000000001000000000000000000001
1000111111111111111110000111111
1000000000000000000000000000001
1000111111111110000000000100111
1000000000000010000000000100001
1110111111000011101111111110001
1000000001000000000000000010001
1000000001000000000000000010001
1111111111111111111111111111111
1
1
1
1111
1001
1111