NO textures/test/north.png



SO         textures/test/south.png


EA     textures/test/east.png
WE      textures/test/west.png

C 135,          206,235



F     34    ,   139,             34

111111111111111
100000000000001
101111111111111
100100010010001
10010E010100001
100100010111111
100111111000001
111111111111111
