NO textures/north.png

SO         textures/south.png

EA     textures/east.png

WE      textures/west.png

C 135, 206,          235

F 107,142,35

111111111111111111111111111111111111111111111111111111111111111111111111111111111111111111111111111111111111111111111
111111111111111111111111111111111111111111111111111111111111111111111111111111111111111111111111111111111111111111111
11111111111111111111111111111111111111111111111111111111111111111111111111111111111111111111111111111111111111111111111111111111111111111111111111111111111111111111111111111111111111111111111111111111111111111
111111111111111111111111111111111111111111111111111111111111111111111111111111111111111111111111111111111111111111111
111111111111111111111111111111111111111111111111111111111111111111111111111000000000000000000000000000001111111111111
111111111111111111111111111111111111111111111111111111111111111111111111111000000000000000000000000000001111111111111
111111111111111111111111111111111111111111111111111111111111111111111111111000000000000000000000000000001111111111111
111111111111111111111111111111111111111111111111111111111111111111111111111000000000000000000000000000001111111111111
1111111111111111111111111111111111111111111111111111111111111111111111111110000000000000000S0000000000001111111111111
111111111111111111111111111111111111111111111111111111111111111111111111111000000000000000000000000000001111111111111
111111111111111111111111111111111111111111111111111111111111111111111111111111111111111111111111111111111111111111111
111111111111111111111111111111111111111111111111111111111111111111111111111111111111111111111111111111111111111111111
111111111111111111111111111111111111111111111111111111111111111111111111111111111111111111111111111111111111111111111
111111111111111111111111111111111111111111111111111111111111111111111111111111111111111111111111111111111111111111111