NO textures/test/north.xpm



SO         textures/test/south.xpm


EA     textures/test/east.xpm
WE      textures/test/west.xpm

C 25,          50,85


F     20    ,   20,             204

11111    11111
10001    11111
10S01    10001
10001    11111
10001
10001
11011
10001
10001
10001
10001
10001
11111
