NO textures/north.png

SO         textures/south.png

EA     textures/east.png

WE      textures/west.png

C 135, 206,          235

F 107,142,35

1111N00011111