NO textures/north.png

SO         textures/south.png

EA     textures/east.png

WE      textures/west.png

C 135, 206,          235

F 107,142,35

11111
10001
10001
10001
10001
10001
11  1
10001
10001
10001
11111
10001
10S01
10001
10001
10001
11  1
10001
10001
10001
11111
10001
10001
10001
10001
10001
11  1
10001
10001
10001
11111
10001
10001
10001
10001
10001
11  1
10001
10001
10001
11111
10001
10001
10001
10001
10001
11  1
10001
10001
10001
11111
10001
10001
10001
10001
10001
11  1
10001
10001
10001
11111
10001
10001
10001
10001
10001
11  1
10001
10001
10001
11111
10001
10001
10001
10001
10001
11  1
10001
10001
10001
11111
10001
10001
10001
10001
10001
11  1
10001
10001
10001
11111
10001
10001
10001
10001
10001
11  1
10001
10001
10001
11111
10001
10001
10001
10001
10001
11  1
10001
10001
11111
